NO assets/twisted_plant.xpm
SO assets/plywood.xpm
EA assets/old_wood.xpm
WE assets/oak_tree.xpm

F 109,  37, 37

C 61,237,243

1111111111111111
1000000000000001
1N00000000000111
1000000000000001
1111111111111111