


NO ./assets/twisted_plant.xpm
SO ./assets/old_wood.xpm
WE ./assets/plywood.xpm
WE ./assets/oak_tree.xpm

F 220,              100,0
C 225,30,0

111111111111111111111
100000000000000W00001
100000000000000000001
100000000000000000001
111111111111111111111