NO ./textures/greystone.xpm
SO ./textures/redbrick.xpm
EA ./textures/wood.xpm
WE ./textures/wood.xpm
C 255,  200,  60
F 	 122,122,122

111111111111111111
1000000000000000W1
111111111111111111
